#######
#.....#
#..T..#
#.$.T.#
#.$...#
#...@.#
#######
