###########
#.@.......#
#.$.$.$.$.#
#.........#
#.T.T.T.T.#
###########
