#######
#.@...#
#.T.T.#
#.....#
#.$.$.#
#.....#
#######
