#######
##...##
##$.$##
.......
.$.@..T
.......
##...##
##T.T##
#######
