#######
#.....#
#.T.T.#
#.$.$.#
#..@..#
#.....#
#######
