#######
#.....#
#.$.T.#
#..@..#
#.T.$.#
#.....#
#######
