#########
#.@.....#
#.$.$.$.#
#.......#
#.T.T.T.#
#########
