########
#......#
#.$..T.#
###..T.#
#......#
#.$..@.#
#..#...#
########
