#######
#.....#
#.T...#
##..$.#
#...$.#
#...T.#
#...@.#
#.....#
#######
