#######
#.....#
#.$T..#
#.@T..#
#..$..#
#.....#
#######
