#######
#.@...#
#.$.$.#
#.....#
#.T.T.#
#######
